1111111
10001C1
1P00E01
1111111
